accept = "Aceitar"
action = "Ação"
angle = "Ângulo"
angles = "Ângulos"
animation = "Animaçãp"
animations = "Animações"
apply = "Aplicar"
apply_changes = "Aplicar alterações"
arguments = "Argumentos"
attachment = "Ligação"
attachments = "Ligações"
blendcontrollers = "Controladores de mistura"
bloom = "Bloom"
bodygroups = "Grupos de corpos"
bone = "Osso"
bones = "Ossos"
brightness = "Brilho"
bruteforce = "Força-Bruta"
bsp_and_octree = "BSP + Octree"
cancel = "Cancelar"
chat = "Chat"
chest = "Peito"
class = "Classe"
clear = "Limpar"
connect = "Conectar"
contrast = "Contraste"
concave = "Concavo"
convex = "Convexo"
decline = "Declive"
disabled = "Desativado"
enabled = "Ativado"
entities = "Entidades"
event = "Evento"
events = "Eventos"
flexes = "Flexões"
fps = "FPS"
frame = "Frame"
gamemode = "Modo de jogo"
gameplay = "Gameplay"
gear = "Engrenagem"
hdrr = "HDRR"
head = "Cabeça"
hitbox = "Hitbox"
hitboxes = "Hitboxes"
hitgroup = "Hitgroup"
id = "ID"
import = "Importar"
info = "Info"
lan_english = "English"
lan_german = "Deutsch"
lan_portuguese = "Portuguese"
language = "Língua"
latency = "Latência"
left_arm = "Braço esquerdo"
left_leg = "Perna esquerda"
loop = "Loop"
map = "Mapa"
mass = "Massa"
material = "Material"
materials = "Materiais"
max = "Máx"
maximum = "Máximo"
min = "Mín"
minimum = "Mínimo"
motion_blur = "Desfoque de movimento"
movement = "Movemento"
music = "Musica"
name = "Nome"
no = "Não"
no_limit = "Sem limite"
none = "Nenhum"
not_found = "Não encontrado"
npcs = "NPCs"
octree = "Octree"
off = "Off"
offset = "Offset"
ok = "OK"
origin = "Origem"
other = "Outro"
password_protected = "PW"
path = "Caminho"
physics = "Físicas"
players = "Jogadores"
preview = "Pré-visualização"
properties = "Propriedades"
props = "Props"
quality = "Qualidade"
refresh = "Atualizar"
remove = "Remover"
reset = "Reset"
right_arm = "Braço direito"
right_leg = "Perna direita"
server_name = "Nome do servidor"
size = "Tamanho"
skeleton = "Esqueleto"
skins = "Skins"
speed = "Velocidade"
ssao = "SSAO"
stomach = "Estomago"
surface_material = "Material de superfície"
texture = "Textura"
textures = "Texturas"
tools = "Ferramentas"
type = "Tipo"
unknown = "Desconhecido"
unsupported_extension = "Extensão não suportada"
value = "Valor"
vehicles = "Veículos"
view = "Visão"
weapons = "Armas"
yes = "Sim"